Layout	1	2	3	4	5	6	7	8	9	10	11	12
A	CGTAT_TCGGA	TCGCT_TCGGA	CTTAG_TCGGA	CGACA_TCGGA	ACTAC_TCGGA	TATAC_TCGGA	GGAAT_TCGGA	AAGTC_TCGGA	AGTAA_TCGGA	AATTG_TCGGA	AGATG_TCGGA	CGCGA_TCGGA
B	CGTAT_GTTTC	TCGCT_GTTTC	CTTAG_GTTTC	CGACA_GTTTC	ACTAC_GTTTC	TATAC_GTTTC	GGAAT_GTTTC	AAGTC_GTTTC	AGTAA_GTTTC	AATTG_GTTTC	AGATG_GTTTC	CGCGA_GTTTC
C	CGTAT_AGCTT	TCGCT_AGCTT	CTTAG_AGCTT	CGACA_AGCTT	ACTAC_AGCTT	TATAC_AGCTT	GGAAT_AGCTT	AAGTC_AGCTT	AGTAA_AGCTT	AATTG_AGCTT	AGATG_AGCTT	CGCGA_AGCTT
D	CGTAT_TCATT	TCGCT_TCATT	CTTAG_TCATT	CGACA_TCATT	ACTAC_TCATT	TATAC_TCATT	GGAAT_TCATT	AAGTC_TCATT	AGTAA_TCATT	AATTG_TCATT	AGATG_TCATT	CGCGA_TCATT
E	CGTAT_GCTCC	TCGCT_GCTCC	CTTAG_GCTCC	CGACA_GCTCC	ACTAC_GCTCC	TATAC_GCTCC	GGAAT_GCTCC	AAGTC_GCTCC	AGTAA_GCTCC	AATTG_GCTCC	AGATG_GCTCC	CGCGA_GCTCC
F	CGTAT_ACTAA	TCGCT_ACTAA	CTTAG_ACTAA	CGACA_ACTAA	ACTAC_ACTAA	TATAC_ACTAA	GGAAT_ACTAA	AAGTC_ACTAA	AGTAA_ACTAA	AATTG_ACTAA	AGATG_ACTAA	CGCGA_ACTAA
G	CGTAT_CGAGG	TCGCT_CGAGG	CTTAG_CGAGG	CGACA_CGAGG	ACTAC_CGAGG	TATAC_CGAGG	GGAAT_CGAGG	AAGTC_CGAGG	AGTAA_CGAGG	AATTG_CGAGG	AGATG_CGAGG	CGCGA_CGAGG
H	CGTAT_ACCGG	TCGCT_ACCGG	CTTAG_ACCGG	CGACA_ACCGG	ACTAC_ACCGG	TATAC_ACCGG	GGAAT_ACCGG	AAGTC_ACCGG	AGTAA_ACCGG	AATTG_ACCGG	AGATG_ACCGG	CGCGA_ACCGG
